    00000000000000000000000000000000000000000000000000000000000000000000000000000000000000000000000000001111111111111111111111111111
    00000000001111111111222222222233333333334444444444555555555566666666667777777777888888888899999999990000000000111111111122222222
    01234567890123456789012345678901234567890123456789012345678901234567890123456789012345678901234567890123456789012345678901234567   
   
    00000000000000001111111111111111222222222222222233333333333333334444444444444444555555555555555566666666666666667777777777777777
    0123456789ABCDEF0123456789ABCDEF0123456789ABCDEF0123456789ABCDEF0123456789ABCDEF0123456789ABCDEF0123456789ABCDEF0123456789ABCDEF
-----------------------------------------------------------------------------------------------------------------------------------
000|22222222222222222222222222222222222222222222222222222222222222222222222222222222222222222222222222222222222222222222222222222222
001|22222222222222222222222222222222222222222222222222222222222222222222222222222222222222222222222222222222222222222222222222222222
002|22000000000000000000000000000000000000000000000000000000000000000000000000000000000000000000000000000000000000000000000000000022
003|22000000000000000000000000000000000000000000000000000000000000000000000000000000000000000000000000000000000000000000000000000022
004|22000000000000000000000000000000000000000000000000000000000000000000000222222222222222222222222222222222222222222222222222200022
005|22000022222222222222222222222222220000000000000000000000000000000000000200000000000000000000000000000000000000000000000000200022
006|22000020001010000000000000000000022200000000000000000000000000000000000200000000000000000000000000000000000000000000000000200022
007|22000020000100000000000000000000000211111111111111112000000000000000000200000000000000000000000000000000000000000000000000200022
008|22000020001010000000000000000000000000000000000000002000000000000000000200000000000000000000000000000000000000000000000000200022
009|22000020000100000000000000000000000000000000000000002111111110000000000200000000000000000000000000000000000000000000000000200022
00A|22000020001010000000000000000000000000000000000000000000000010000000000200000000000000000000000000000000000000000000000000200022
00B|22000020000100000000000000000000000000000000000000000000000010000000000200000000000000000000000000000000000000000000000000200022
00C|22000020001010000000000000000000000000000000000000000000000010000000000200000000000000000000000000000000000000000000000000200022
00D|22000020000100000000000000000000000000000000000000000000000010000000000200000000000000000000000000222222222222222222222222200022
00E|22000020001010000000000000000000000000000000000000000000000010000000000200000000000000000000000002200000000000000000000000000022
00F|22000020000100000000000000000000000000000000000000000000000010000000000200000000000000000000000022000000000000000000000000000022
010|22000020001010000000000000000000000000000000000000000000000010000000000200000000000000000000002200000000000000000000000000000022
011|22000020000100000000000000000000000000000000000000000000000010000000000200000000000000000000022000000000000000000000000000000022
012|22000020001010000000000000000000000000000000000000000000000010000000000200000000000000000002220000000000000000000000000000000022
013|22000020000100000000000000000000000000000000000000000000000010000000000200000000000000000022000000022220222222022202222022222022
014|22000020001010000000000000000000000000000000000000000000000010000000000200000000000000002220000000222000000200022202002200200022
015|22000020000100000000000000000000000000000000000000000000000002222200000200000000000000022000000000220000000200020202000200200022
016|22000020001010000000000000000000000000000000000000000000000000000200000200000000000002220000000000022000000200020202002200200022
017|22000020000100000000000000000000000000000000000000000000000000000200000200000000000022000000000000002220000200020202222000200022
018|22000020001010000000000000000000000000000000000000000000000000000200000200000000000020000000000000000022000200022202020000200022
019|22000020000100000000000000000000000000000000000000000000000000000200000200000000000002220000000000000002000200020202020000200022
01A|22000020001010000000000000000000000000000000000000000000000000000200000200000000000000002000000000000022000200020202020000200022
01B|22000022222222222222222200000000000000000000000000000000000000000200000200000000000000000222000000002222000200020202020000200022
01C|22000000000000000000000200000000000000000000000000000000000000000200000200000000000000000002220000002220000200020202020000200022
01D|22000000000000000000000200000000000000000000000000000000000000000200000200000000000000000000022200000000000000000000000000000022
01E|22000000000000000000000200000000000000000000000000000000000000000200000200000000000000000000000220000000000000000000000000000022
01F|22000000000000000000000200000000000000000000000000000000000000000200000200000000000000000000000002222000000000000000000000000022
020|22000000000000000000000200000000000000000000000000000000000000000200000200000000000000000000000000022200000000000000000000000022
021|22000000000000000000000200000000000000000000000000000000000000000200000200000000000000000000000000002222222222222222222220000022
022|22000000000000000000000200000000000000000000000000000000000000000200000200000000000000000000000000000000000000000000000020000022
023|22000000000000000000000200000000000000000000000000000000222222222200000200000000000000000000000000000000000000000000000020000022
024|22000000000000000000000200000000000000000000000000000000200000000000000200000000000000000000000000000000000000000000000020000022
025|22000000000000000000000200000000000000000000000000000000200000000000000200000000000000000000000000000000000000000000000020000022
026|22000000000000000000000200000000000000000000000000000000200000000000000200000000000000000000000000000000000000000000000020000022
027|22000000002222222222222200000000000000000000000000000000200000000000000200000000000000000000000000000000000000000000000020000022
028|22000000002000000000000000000000000000000000000000000000200000000000000200000000000000000000000000000000000000000000000020000022
029|22000000002000000000000000000000000000000000000000000000220000000000000200000000000000000000000000000000000000000000000020000022
02A|22000000002000000000000000000000000000000000000000000000020000000000000200000000000000000000000000000000000000000000000020000022
02B|22000000002000000000000000000000000000022222222222222222220000000000000200000000000000000000000000000000000000000000000020000022
02C|22000000002000000000000000000000000000020000000000000000000000000000000200000000000000000000000000000000000000000000000020000022
02D|22000000002000000000000000000000000000020000000000000000000000000000000200000000000000000000000000000000000000000000000020000022
02E|22000000002000000000000000000000000000020000000000000000000000000000000200000000000000000000000000000000000000000000000020000022
02F|22000000002000000000000000000000000000020000000000000000000000000000000200000000000000000000000000000000000000000000000020000022
030|22000000002000000000000000000000000000020000000000000000000000000000000200000000000000000000000000000000000000000000000020000022
031|22000000002000000000000000000000000000020000000000000000000000000000000200000000000000000000000000000000000000000000000020000022
032|22000000002000000000000000000000000000020000000000000000000000000000000200000000000000000000000000000000000000000000000020000022
033|22000000002000000000000000000000000000020000000000000000000000000000000200000000000000000000000000000000000000000000000020000022
034|22000000002000000000000000000000000000020000000000000000000000000000000200000000000000000000000000000000000000000000000020000022
035|22000000002000000000000000000000000000022222222222222222222222222000000200000000000000000000000000000000000000000000000020000022
036|22000000002000000000000000000000000000000000000000000000000000002000000222222222000000000000000000000000000000000000000020000022
037|22000000002000000000000000000000000000000000000000000000000000002000000000000002000000000000000000000000000000000000000020000022
038|22000000002000000000000000000000000000000000000000000000000000002000000000000002000000000000000000000000000000000000000020000022
039|22000000002000000000000000000000000000000000000000000000000000002000000000000002000000000000000000000000000000000000000020000022
03A|22000000002000000000000000000000000000000000000000000000000000002000000000000002000000000000000002222222000000000000000020000022
03B|22000000002000000000000000000000000000000000000000000000000000002000000000000002000000000002022222000000222220000000000020000022
03C|22000000002000000000000000000000000000000000000000000000000000002000000000000002000000000022000000000000000020000000000020000022
03D|22000000002222222222222222200000000000000000000000000000000000002000000000000002000000000020000000000000000020000000000020000022
03E|22000000000000000000000000200000000000000000000000000000000000002000000000000002000000000020000000000000000002000000000020000022
03F|22000000000000000000000000200000000000000000000000000000000000002000000000000002000000000020000000000000000002000000000020000022
040|22000000000000000000000000200000000000000000000000000000000000002000000000000002000000000020000000000000000002000000000020000022
041|22000000000000000000000000200000000000000000000000000000000000002000000000000002000000000020000000000000000002000000000020000022
042|22000000000000000000000000200000000000000000000000000000000000002000000000000002000000000020000000000000000002000000000020000022
043|22000000000000000000000000200000000000000000000000000000000000002222222200000002000000000022222222200000000002000000000022200022
044|22000000000000000000000000200000000000000000000000000000000000000000000200000002000000000000000000022222222002000000000000200022
045|22000000000000000000000000200000000000000000000000000000000000000000000200000002000000000000000000000000000220000000000000200022
046|22000000000000000000000000200000000000000000000000000000000000000000000200000002000000000000000000000000000000000000000000200022
047|22000000000000000000000000200000000000000000000000000000000000000000000200000002000000000000000000000000000000000000000000200022
048|22000000000000000000000000222222222222222222222000000000000000000000000200000002000000000000000000000000000000000000000000200022
049|22000000000000000000000000000000000000000000002000000000000000000000000200000002000000000000000000000000000000000000000000200022
04A|22000000000000000000000000000000000000000000002000000000000000000000000200000002000000000000000000000000000000000000000000200022
04B|22000000000000000000000000000000000000000000002000000000000000000000000200000002000000000000000000000000000000000000000000200022
04C|22000000000000000000000000000000000000000000002000000000000000000000000200000002000000000000000000000000000000000000000000200022
04D|22000000000000000000000000000000000000000000002000000000000000000000000200000002000000000000000000000000000000000000000000200022
04E|22000000000000000000000000222222222222222222222000000000000000000000000200000002000000000000000000000000000000000000000000200022
04F|22000000000000000000000000200000000000000000000000000000000000000000000200000002000000000000000000000000000000000000000000200022
050|22000000000000000000000000200000000000000000000000000000000000000000000200000002000000000000000000000000000000000000000000200022
051|22000000000000000000000000200000000000000000000000000000000000000000000200000002000000000000000000000000000000000000000000200022
052|22000000000000000000000000200000000000000000000000000000000000000000000200000002000000000000000000000000000000000000000000200022
053|22000000000000000000000000200000000000000000000000000000000000000000000200000002000000000000000000000000000000000000000000200022
054|22000000000000000000000000200000000000000000000000000000000000000000000200000002222222222222220000000000000000000000000000200022
055|22000000000000000000000000200000000000000000000000000000000002222222222200000000000000000000020000000000000000000000000000200022
056|22000000000000000000000000200000000000000000000000000000000002000000000000000000000000000000020000000000000000000000000000200022
057|22000000000000000000000000200000000000000000000000000000000002000000000000000000000000000000020000000000000000000000000000200022
058|22000000000000000000000000200000000000000000000000000000000002000000000000000000000000000000020000000000000000000000000000200022
059|22000000000000000000000000200000000000000000000000000000000002000000000000000000000000000000020000000000000000000000000000200022
05A|22000000000000000000000000200000000000000000000000000000000002000000000000000000000000000000020000000000000000000000000000200022
05B|22000000000000000000000000200000000000000000000000000000000002000000000000000000000000000000020000000000000000000000000000200022
05C|22000000000000000000000000200000000000000000000000000000000002000000000000000000000000000000020000000000000000000000000000200022
05D|22000000000000000000000000200000000000000000000000000000000002000000000000000000000000000000020000000000000000000000000000200022
05E|22000000000000000000000000200000000000000000000000000000000002000000000000000000000000000000020000000000000000000000000000200022
05F|22000000000000000000000000200000000000000000000000000000000002000000000000000000000000000000020000000000000000000000000000200022
060|22000000000000000000000000200000000000000000000000000000000002000000000000000000000000000000020000000000000000000000000000200022
061|22000000000002222222222222200000000000000000002222220000000002000000000000002222222222222222220000000000000000000000000000200022
062|22000000000002000000000000000000000000002222222000022000000002000000000000002000000000000000000000000000000000000000000000200022
063|22000000000002000000000000000000000000022000000000002200000002000000000000002000000000000000000000000000000000000000000000200022
064|22000000000002000000000000000000000000020000000000000200000002222222222222222000000000000000000000000000000000000000000000200022
065|22000000000002000000000000000000000000020000000000000200000000000000000000000000000000000000000000000000000000000000000000200022
066|22000000000002000000000000000000000000020000000000000200000000000000000000000000000000000000000000000000000000000000000000200022
067|22000000000002000000000000000000000000020000000000000200000000000000000000000000000000000000000000000000000000000000000000200022
068|22000000000002000000000000000000000000020000000000002200000000000000000000000000000000000000000000000000000000222222222222200022
069|22000000000002000000000000000000000000002000000000022000000000000000000000000000000000000000000000000000000000200000000000000022
06A|22000000000002000000000000000000000000002220000000220000000000000000000000000000000000000000000000000000000000200000000000000022
06B|22000000000002000000000000000000000000000022222222200000000000000000000000000000000000000000000000000000000000200000000000000022
06C|22000000000002000000000000000000000000000000000000000000000000000000000000000000000000000000000000000000000000200000000000000022
06D|22000000000002000000000000000000000000000000000000000000000000000000000000000000000000000000000000000000000000200000000000000022
06E|22000000000002000000000000000000000000000000000000000000000000000000000000000000000000000000000000000000000000200000000000000022
06F|22000000000002000000000000000000000000000000000000000000000000000000000000000000000000000000000000000000000000200000000000000022
070|22000000000002000000000000000000000000000000000000000000000000000000000000000000000000000000000000000000000000200000000000000022
071|22000000000002000000000000000000000000000000000000000000000000000000000000000000000000000000000000000000000000200000000000000022
072|22000000000002000000000000000000000000000000000000000000000000000000000000000000000000000000000000000000000000200000000000000022
073|22000000000002000000000000000000000000000000000000000000000000000000000000000000000000000000000000000000000000200000000000000022
074|22000000000002000000000000000000000000000000000000000000000000000000000000000000000000000000000000000000000000200000000000000022
075|22000000000002000000000000000000000000000000000000000000000000000000000000000000000000000000000000000000000000200000000000000022
076|22000000000002222222222222222222222222222222222000000000000000000000000000000000000000000000000000000000000000200000000000000022
077|22000000000000000000000000000000000000000000002000000000000000000000000000000000022222222222222222222222222222200000000000000022
078|22000000000000000000000000000000000000000000002000000000000000000000000000000000020000000000000000000000000000000000000000000022
079|22000000000000000000000000000000000000000000002000000000000000000000000000000000020000000000000000000000000000000000000000000022
07A|22000000000000000000000000000000000000000000002222222222222222222222222222222222220000000000000000000000000000000000000000000022
07B|22000000000000000000000000000000000000000000000000000000000000000000000000000000000000000000000000000000000000000000000000000022
07C|22000000000000000000000000000000000000000000000000000000000000000000000000000000000000000000000000000000000000000000000000000022
07D|22000000000000000000000000000000000000000000000000000000000000000000000000000000000000000000000000000000000000000000000000000022
07E|22222222222222222222222222222222222222222222222222222222222222222222222222222222222222222222222222222222222222222222222222222222
07F|22222222222222222222222222222222222222222222222222222222222222222222222222222222222222222222222222222222222222222222222222222222

