    00000000000000000000000000000000000000000000000000000000000000000000000000000000000000000000000000001111111111111111111111111111
    00000000001111111111222222222233333333334444444444555555555566666666667777777777888888888899999999990000000000111111111122222222
    01234567890123456789012345678901234567890123456789012345678901234567890123456789012345678901234567890123456789012345678901234567   
   
    00000000000000001111111111111111222222222222222233333333333333334444444444444444555555555555555566666666666666667777777777777777
    0123456789ABCDEF0123456789ABCDEF0123456789ABCDEF0123456789ABCDEF0123456789ABCDEF0123456789ABCDEF0123456789ABCDEF0123456789ABCDEF
-----------------------------------------------------------------------------------------------------------------------------------

000|00000000000000000000000000000000000000000000000000000000000000000000000000000000000000000000000000000000000000000000000000000000
001|00000000000000000000000000000000000000000000000000000000000000000000000000000000000000000000000000000000000000000000000000000000
002|00000000000000000000000000000000000000000000000000000000000000000000000000000000000000000000000000000000000000000000000000000000
003|00000000000000000000000000000000000000000000000000000000000000000000000000000000000000000000000000000000000000000000000000000000
004|00000000000000000000000000000000000000000000000000000000000000000000000000000000000000000000000000000000000000000000000000000000
005|00000000000000000000000000000222220000022222222222222222222222222222222222222222222222222222222000000000000000000000000000000000
006|00000000002200222202220022200002000000020000000000000000000000000000000000000000000000000000002000000000000000000000000000000000
007|00000000022000002002220020220002000000020000000000000000000000000000000000000000000000000000002000000000000000000000000000000000
008|00000000020000002002002020022002000000020000000000000000000000000000000000000000000000000000002000000000000000000000000000000000
009|00000000020000002002002020022002000000020000000000000000000000000000000000000000000000000000002000000000000000000000000000000000
00A|00000000022000002002002020220002000000020000000000000000000000000000000000000000000000000000002000000000000000000000000000000000
00B|00000000002220002002002022200002000000020000000000000000000000000000000000000000000000000000002000000000000000000000000000000000
00C|00000000000002002022222020220002000000020000000000000000000000000000000000000000000000000000002000000000000000000000000000000000
00D|00000000000002002020002020020002000000020000000000000000000000000000000000000000000000000000002000000000000000000000000000000000
00E|00000000000002002020002020020002000000020000000000000000000000000000000000000000000000000000002000000000000000000000000000000000
00F|00000000000022002020002020020002000000020000000000000000000000000000000000000000000000000000002000000000000000000000000000000000
010|00000000002220002020022020020002000000020000000000000000000000000000000000000000000000000000002000000000000000000000000000000000
011|00000000000000000000000000000000000000020000000000000000000000000000000000000000000000000000002000000000000000000000000000000000
012|00000000000000000000000000000000000000022222222222222222222000000000000002222222222222222222222000000000000000000000000000000000
013|00000000000000000000000000000000000000000000000000000000002000000000000002000000000000000000000000000000000000000000000000000000
014|00000000000000000000000000000000000000000000000000000000002000000000000002000000000000000000000000000000000000000000000000000000
015|00000000000000000000000000000000000000000000000000000000002000000000000002000000000000000000000000000000000000000000000000000000
016|00000000000000000000000000000000000000000000000000000000002000000000000002000000000000000000000000000000000000000000000000000000
017|00000000000000000000000000000000000000000000000000000000002000000000000002000000000000000000000000000000000000000000000000000000
018|00000000000000000000000000000000000000000000000000000000002000000000000002000000000000000000000000000000000000000000000000000000
019|00000000000000000000000000000000000000000000000000000000002000000000000002000000000000000000000000000000000000000000000000000000
01A|00000000000000000000000000000000000000000000000000000000002000000000000002000000000000000000000000000000000000000000000000000000
01B|00000000000000000000000000000000000000000000000000000000002000000000000002000000000000000000000000000000000000000000000000000000
01C|00000000000000000000000000000000000000000000000000000000002000000000000002000000000000000000000000000000000000000000000000000000
01D|00000000000000000000000000000000000000000000000000000000002000000000000002000000000000000000000000000000000000000000000000000000
01E|00000000000000000000000000000000000000000000000000000000002000000000000002000000000000000000000000000000000000000000000000000000
01F|00000000000000000000000000000000000000000000000000000000002000000000000002000000000000000000000000000000000000000000000000000000
020|00000000000000000000000000000000000000000000000000000000002000000000000002000000000000000000000000000000000000000000000000000000
021|00000000000000000000000000000000000000000000000000000000002000000000000002000000000000000000000000000000000000000000000000000000
022|00000000000000000000000000000000000000000000000000000000002000000000000002000000000000000000000000000000000000000000000000000000
023|00000000000000000000000000000000000000000000000000000000222000000000000002220000000000000000000000000000000000000000000000000000
024|00000000000000000000000000000000000000000000000000000222000000000000000000002220000000000000000000000000000000000000000000000000
025|00000000000000000000000000000000000000000000000000022000000000000000000000000002200000000000000000000000000000000000000000000000
026|00000000000000000000000000000000000000000000000000200000000000000000000000000000020000000000000000000000000000000000000000000000
027|00000000000000000000000000000000000000000000000022000000000000000000000000000000002200000000000000000000000000000000000000000000
028|00000000000000000000000000000000000000000000000200000000000000000000000000000000000020000000000000000000000000000000000000000000
029|00000000000000000000000000000000000000000000002000000000000000000000000000000000000002000000000000000000000000000000000000000000
02A|00000000000000000000000000000000000000000000220000000000000000000000000000000000000000220000000000000000000000000000000000000000
02B|00000000000000000000000000000000000000000002000000000000000002222222222000000000000000002000000000000000000000000000000000000000
02C|00000000000000000000000000000000000000000020000000000000002222222222222222000000000000000200000000000000000000000000000000000000
02D|00000000000000000000000000000000000000000020000000000002222222222222222222222000000000000200000000000000000000000000000000000000
02E|00000000000000000000000000000000000000000200000000000022222222222222222222222200000000000020000000000000000000000000000000000000
02F|00000000000000000000000000000000000000002000000000002222222222222222222222222222000000000002000000000000000000000000000000000000
030|00000000000000000000000000000000000000020000000000022222222222222222222222222222200000000000200000000000000000000000000000000000
031|00000000000000000000000000000000000000020000000000222222222222222222222222222222220000000000200000000000000000000000000000000000
032|00000000000000000000000000000000000000200000000002222222222222222222222222222222222000000000020000000000000000000000000000000000
033|00000000000000000000000000000000000000200000000022222222222222222222222222222222222200000000020000000000000000000000000000000000
034|00000000000000000000000000000000000002000000000222222222222222222222222222222222222220000000002000000000000000000000000000000000
035|00000000000000000000000000000000000002000000000222222222222222222222222222222222222220000000002000000000000000000000000000000000
036|00000000000000000000000000000000000020000000002222222222222222222222222222222222222222000000000200000000000000000000000000000000
037|00000000000000000000000000000000000020000000022222222222222222222222222222222222222222200000000200000000000000000000000000000000
038|00000000000000000000000000000000000020000000022222222222222222222222222222222222222222200000000200000000000000000000000000000000
039|00000000000000000000000000000000000200000000022222222222222222222222222222222222222222200000000020000000000000000000000000000000
03A|00000000000000000000000000000000000200000000222222222222222222222222222222222222222222220000000020000000000000000000000000000000
03B|00000000000000000000000000000000000200000000222222222222222222222222222222222222222222220000000020000000000000000000000000000000
03C|00000000000000000000000000000000000200000000222222222222222222222222222222222222222222220000000020000000000000000000000000000000
03D|00000000000000000000000000000000002000000002222222222222222222222222222222222222222222222000000002000000000000000000000000000000
03E|00000000000000000000000000000000002000000002222222222222222222222222222222222222222222222000000002000000000000000000000000000000
03F|00000000000000000000000000000000002000000002222222222222222222222222222222222222222222222000000002000000000000000000000000000000
040|00000000000000000000000000000000002000000002222222222222222222222000222222222222222222222000000002000000000000000000000000000000
041|00000000000000000000000000000000002000000002222222222222222222220000022222222222222222222000000002000000000000000000000000000000
042|00000000000000000000000000000000002000000002222222222222222222220000022222222222222222222000000002000000000000000000000000000000
043|00000000000000000000000000000000002000000002000000000000000000020000020000000000000000002000000002000000000000000000000000000000
044|00000000000000000000000000000000002000000002000000000000000000002000200000000000000000002000000002000000000000000000000000000000
045|00000000000000000000000000000000002000000002000000000000000000000222000000000000000000002000000002000000000000000000000000000000
046|00000000000000000000000000000000002000000002000000000000000000000000000000000000000000002000000002000000000000000000000000000000
047|00000000000000000000000000000000002000000000200000000000000000000000000000000000000000020000000002000000000000000000000000000000
048|00000000000000000000000000000000000200000000200000000000000000000000000000000000000000020000000020000000000000000000000000000000
049|00000000000000000000000000000000000200000000200000000000000000000000000000000000000000020000000020000000000000000000000000000000
04A|00000000000000000000000000000000000200000000020000000000000000000000000000000000000000200000000020000000000000000000000000000000
04B|00000000000000000000000000000000000200000000020000000000000000000000000000000000000000200000000020000000000000000000000000000000
04C|00000000000000000000000000000000000020000000020000000000000000000000000000000000000000200000000200000000000000000000000000000000
04D|00000000000000000000000000000000000020000000002000000000000000000000000000000000000002000000000200000000000000000000000000000000
04E|00000000000000000000000000000000000020000000000200000000000000000000000000000000000020000000000200000000000000000000000000000000
04F|00000000000000000000000000000000000002000000000200000000000000000000000000000000000020000000002000000000000000000000000000000000
050|00000000000000000000000000000000000002000000000020000000000000000000000000000000000200000000002000000000000000000000000000000000
051|00000000000000000000000000000000000000200000000002000000000000000000000000000000002000000000020000000000000000000000000000000000
052|00000000000000000000000000000000000000200000000000200000000000000000000000000000020000000000020000000000000000000000000000000000
053|00000000000000000000000000000000000000020000000000020000000000000000000000000000200000000000200000000000000000000000000000000000
054|00000000000000000000000000000000000000020000000000002200000000000000000000000022000000000000200000000000000000000000000000000000
055|00000000000000000000000000000000000000002000000000000020000000000000000000000200000000000002000000000000000000000000000000000000
056|00000000000000000000000000000000000000000200000000000002220000000000000000222000000000000020000000000000000000000000000000000000
057|00000000000000000000000000000000000000000020000000000000002220000000000222000000000000000200000000000000000000000000000000000000
058|00000000000000000000000000000000000000000020000000000000000002222222222000000000000000000200000000000000000000000000000000000000
059|00000000000000000000000000000000000000000002000000000000000000000000000000000000000000002000000000000000000000000000000000000000
05A|00000000000000000000000000000000000000000000220000000000000000000000000000000000000000220000000000000000000000000000000000000000
05B|00000000000000000000000000000000000000000000002000000000000000000000000000000000000002000000000000000000000000000000000000000000
05C|00000000000000000000000000000000000000000000000200000000000000000000000000000000000020000000000000000000000000000000000000000000
05D|00000000000000000000000000000000000000000000000022000000000000000000000000000000002200000000000000000000000000000000000000000000
05E|00000000000000000000000000000000000000000000000000200000000000000000000000000000020000000000000000000000000000000000000000000000
05F|00000000000000000000000000000000000000000000000000022000000000000000000000000002200000000000000000000000000000000000000000000000
060|00000000000000000000000000000000000000000000000000000222000000000000000000002220000000000000000000000000000000000000000000000000
061|00000000000000000000000000000000000000000000000000000000222000000000000000220000000000000000000000000000000000000000000000000000
062|00000000000000000000000000000000000000000000000000000000002000000000000000200000000000000000000000000000000000000000000000000000
063|00000000000000000000000000000000000000000000000000000000002000000000000000200000000000000000000000000000000000000000000000000000
064|00000000000000000000000000000000000000000000000000000000002000000000000000200000000000000000000000000000000000000000000000000000
065|00000000000000000000000000000000000000000000000000000000002000000000000000200000000000000000000000000000000000000000000000000000
066|00000000000000000000000000000000000000000000000000000000002000000000000000200000000000000000000000000000000000000000000000000000
067|00000000000000000000000000000000000000000000000000000000002000000000000000200000000000000000000000000000000000000000000000000000
068|00000000000000000000000000000000000000000000000000000000002000000000000000200000000000000000000000000000000000000000000000000000
069|00000000000000000000000000000000000000000000000000000000002000000000000000200000000000000000000000000000000000000000000000000000
06A|00000000000000000000000000000000000000000000000000000000002000000000000000200000000000000000000000000000000000000000000000000000
06B|00000000000000000000000000000000000000000000000000000000002000000000000000200000000000000000000000000000000000000000000000000000
06C|00000000000000000000000000000000000000000000000000000000002000000000000000200000000000000000000000000000000000000000000000000000
06D|00000000000000000000000000000000000000000000000000000000002000000000000000200000000000000000000000000000000000000000000000000000
06E|00000000000000000000000000000000000000000000000000000000002000000000000000200000000000000000000000000000000000000000000000000000
06F|00000000000000000000000000000000000000000000000000000000002000000000000000200000000000000000000000000000000000000000000000000000
070|00000000000000000000000000000000000000000000000000000000002000000000000000200000000000000000000000000000000000000000000000000000
071|00000000000000000000000000000000000000000000000000000000002000000000000000200000000000000000000000000000000000000000000000000000
072|00000000000000000000000000000000000000000000000000000000002000000000000000200000000000000000000000000000000000000000000000000000
073|00000000000000000000000000000000000000000000000000000000002000000000000000200000000000000000000000000000000000000000000000000000
074|00000000000000000000000000000000000000000000000000000000002000000000000000200000000000000000000000000000000000000000000000000000
075|00000000000000000000000000000000000000000000000000000000002000000000000000200000000000000000000000000000000000000000000000000000
076|00000000000000000000000000000000000000000000000000000000002000000000000000200000000000000000000000000000000000000000000000000000
077|00000000000000000000000000000000000000000000000000000000002000000000000000200000000000000000000000000000000000000000000000000000
078|00000000000000000000000000000000000000000000000000000000002000000000000000200000000000000000000000000000000000000000000000000000
079|00000000000000000000000000000000000000000000000000000000002000000000000000200000000000000000000000000000000000000000000000000000
07A|00000000000000000000000000000000000000000000000000000000002101010101010101200000000000000000000000000000000000000000000000000000
07B|00000000000000000000000000000000000000000000000000000000002010101010101010200000000000000000000000000000000000000000000000000000
07C|00000000000000000000000000000000000000000000000000000000002101010101010101200000000000000000000000000000000000000000000000000000
07D|00000000000000000000000000000000000000000000000000000000002000000000000000200000000000000000000000000000000000000000000000000000
07E|00000000000000000000000000000000000000000000000000000000002222222222222222200000000000000000000000000000000000000000000000000000
07F|00000000000000000000000000000000000000000000000000000000000000000000000000000000000000000000000000000000000000000000000000000000
